{
    "name": "Level 4",
    "id": "level4",
    "from": "level3",
    "to": "level5",
    "data": [   
        [ -2,      -2,     -2,     -2,     -2,     -2,     -2,     -2,     -2,     -2,     -2,     -2,     -2,     -2,     -2,     -2,     -2,     -2,     -2,     -2    ],
        [   0,      0,      0,      0,      0,      0,      0,      0,      0,      0,      0,      0,      0,      0,      0,      0,      0,      0,      0,      0    ],
        [   0,      0,    332,    342,    342,    342,    342,    342,    342,    342,    342,    342,    342,    342,    342,    342,    352,      0,      0,      0    ],
        [   0,      0,     -2,     -2,     -2,    -2,      -2,     -2,     -2,     -2,     -2,     -2,     -2,     -2,     -2,     -2,     -2,      0,      0,      0    ],
        [   0,      0,      0,      0,      0,      0,      0,      0,      0,      0,      0,      0,      0,      0,      0,      0,      0,    362,      0,      0    ],
        [   0,      0,    362,      0,      0,    362,      0,      0,    362,      0,      0,    362,      0,      0,      0,      0,      0,     -2,      0,      0    ],
        [   0,      0,     -2,      0,      0,     -2,      0,      0,     -2,      0,      0,     -2,      0,      0,      0,      0,      0,      0,    362,      0    ],
        [   0,      0,      0,      0,      0,      0,      0,      0,      0,      0,      0,      0,      0,      0,      0,      0,      0,      0,      0,      0    ],
        [   0,      0,    362,      0,      0,    362,      0,      0,    362,      0,      0,    362,      0,      0,      0,      0,      0,      0,      0,    362    ],
        [   0,      0,      0,      0,      0,     -2,      0,      0,     -2,      0,      0,     -2,      0,      0,    362,      0,      0,    362,      0,      0    ],
        [   2,      0,      0,    362,      0,      0,    362,      0,      0,    362,      0,      0,    362,      0,     -2,      0,      0,      0,      0,      0    ],
        [ 362,      1,      0,     -2,      0,      0,     -2,      0,      0,     -2,      0,      0,     -2,      0,      0,    362,      0,      0,      0,      0    ],
        [   0,    362,      0,      0,      0,      0,      0,      0,      0,      0,      0,      0,      0,      0,      0,     -2,      0,      0,      0,      0    ],
        [   0,      0,      0,      0,      0,      0,      0,      0,      0,      0,      0,      0,      0,      0,      0,      0,    362,      0,      0,      0    ],
        [   0,      0,      0,      0,      0,      0,      0,      0,      0,      0,      0,      0,      0,      0,      0,      0,     -2,      0,    362,      0    ],
        [   0,      0,      0,      0,      0,      0,      0,      0,      0,      0,      0,      0,      0,      0,      0,      0,      0,      0,      0,      0    ],
        [  -1,      0,    362,      0,      0,      0,    362,      0,      0,      0,    362,      0,      0,      0,    362,      0,      0,      0,      0,    362    ],
        [ 362,      0,      0,      0,    362,      0,      0,      0,    362,      0,      0,      0,    362,      0,      0,      0,    362,      0,      0,     -2    ],
        [   0,      0,      0,      0,      0,      0,      0,      0,      0,      0,      0,      0,      0,      0,      0,      0,      0,      0,    362,      0    ],
        [   2,      2,      2,      2,      2,      2,      2,      2,      2,      2,      2,      2,      2,      2,      2,      2,      2,      2,      2,      2    ]
    ]
}