{
    "name": "Level 3",
    "id": "level3",
    "from": "level2",
    "to": "level4",
    "data": [   
        [  -2,      0,      0,      0,      0,      0,      0,      0,      0,      0,      0,      0,      0,      0,      0,      0,      0,      0,      0,      0    ],
        [   0,      0,      0,      0,      0,      0,    362,      0,      0,      0,      0,      0,      0,      0,      0,      0,      0,      0,      0,      0    ],
        [   0,      0,    362,      0,    362,      0,     -2,      0,      0,      0,      0,      0,      0,    362,      0,      0,      0,      0,    362,      0    ],
        [   0,      0,      0,      0,     -2,      0,      0,      0,      0,      0,      0,      0,      0,      0,      0,    362,      0,      0,      0,      0    ],
        [   0,    362,      0,    362,      0,      0,      0,    362,      0,      0,      0,      0,      0,      0,      0,      0,      0,      0,      0,    362    ],
        [   0,      0,      0,     -2,      0,      0,      0,     -2,      0,      0,      0,      0,      0,      0,      0,      0,      0,      0,      0,      0    ],
        [ 362,      0,      0,      0,      0,      0,      0,      0,      0,      0,      0,      0,      0,      0,      0,      0,      0,      0,    362,      0    ],
        [   0,      0,      0,      0,      0,      0,      0,      0,    362,      0,      0,      0,      0,      0,      0,      0,      0,      0,      0,      0    ],
        [   0,    362,      0,      0,      0,      0,      0,      0,     -2,      2,      0,      0,      0,      0,      0,      0,      0,      0,      0,    362    ],
        [   0,      0,      0,      0,      0,      0,      0,      0,      0,    370,      0,      0,      0,      0,      0,      0,      0,      0,      0,      0    ],
        [ 362,      0,      0,      0,      0,      0,      0,    362,      0,    371,      0,      0,      0,      0,      0,      0,      0,      0,    362,      0    ],
        [   0,      0,      0,      0,      0,      0,      0,      0,      0,    371,      0,      0,      0,      0,      0,      0,      0,      0,      0,      0    ],
        [   0,    362,      0,      0,      0,      0,      0,      0,    362,    371,      2,      0,      1,      0,      0,      0,      0,      0,      0,    362    ],
        [   0,      0,      0,      0,      0,      0,      0,      0,      0,    301,    350,    310,    320,      2,      2,      2,      2,      0,      0,      0    ],
        [   0,      0,    362,      0,      0,      0,      0,      0,      0,    302,    312,    312,    312,    342,    342,    342,    352,      0,    362,      0    ],
        [   0,      0,      0,      0,      0,      0,      0,    362,      0,      0,      0,      0,      0,      0,      0,      0,      0,      0,      0,      0    ],
        [   0,      0,      0,    362,      0,      0,      0,      0,      0,      0,      0,      0,      0,      0,      0,      0,      0,      0,      0,    362    ],
        [  -1,      0,      0,      0,      0,      0,      0,      0,      0,      0,      0,      0,      0,      0,      0,      0,      0,      0,      0,      0    ],
        [ 332,    342,    352,      0,      0,      0,      0,      0,    362,      0,      0,      0,      0,    362,      0,      0,      0,      0,    362,      0    ],
        [   0,      0,      0,      0,      0,      0,      0,      0,      0,      0,      0,    362,      0,      0,      0,      0,    362,      0,      0,      0    ]
    ]
}