{
    "name": "Level 1",
    "id": "level1",
    "from": "level0",
    "to": "level2",
    "data": [   
        [   0,      0,      0,      0,      0,      0,      0,      0,      0,      0,      0,      0,      0,      0,      0,      0,      0,      0,      0,      0    ],
        [   0,      0,      0,      0,      0,      0,      0,      0,      0,      0,      0,      0,      0,      0,      0,      0,      0,      0,      0,      0    ],
        [   0,      0,      0,      0,      0,      0,      0,      0,      0,      0,      0,      0,      0,      0,      0,      0,      0,      0,      0,      0    ],
        [   0,      0,      0,      0,      0,      0,      0,      0,      0,      0,      0,      0,      0,      0,      0,      0,      0,      0,      0,      0    ],
        [   0,      0,      0,      0,      0,      0,      0,      0,      0,      0,      0,      0,      0,      0,      0,      0,      0,      0,      0,      0    ],
        [   0,      0,      0,      0,      0,      0,      0,      0,      0,      0,      0,      0,      0,      0,      0,      0,      0,      0,      0,      0    ],
        [   0,      0,      0,      0,      0,      0,      0,      0,      0,      0,      0,      0,      0,      0,      0,      0,      0,      0,      0,      0    ],
        [   0,      0,      0,      0,      0,      0,      0,      0,      0,      0,      0,      0,      0,      0,      0,      0,      0,      0,      0,      0    ],
        [   0,      0,      0,      0,      0,      0,      0,      0,      0,      0,      0,      0,      0,      0,      0,      0,      0,      0,      0,      0    ],
        [   0,      0,      0,      0,      0,      0,      0,      0,      0,      0,      0,      0,      0,      0,      0,      0,      0,      0,      0,      0    ],
        [   0,      0,      0,      0,      0,      0,      0,      0,      0,    300,    320,      2,      0,      0,      0,      0,      0,      0,      0,      0    ],
        [   0,      0,      0,      0,      0,      0,      0,      0,    300,    331,    331,    320,      0,      0,      0,      0,      0,      0,      0,      0    ],
        [   0,      0,      0,      0,      0,      0,      0,    300,    341,    331,    331,    341,    320,      2,      0,      0,      0,      0,      0,      0    ],
        [   0,      0,      0,      0,      0,      0,    300,    331,    331,    331,    331,    331,    331,    320,      0,      0,      0,      0,      0,      0    ],
        [   0,      0,      0,      0,      0,    300,    331,    331,    331,    331,    331,    331,    331,    331,    320,      2,      0,      0,      0,      0    ],
        [   0,      0,      0,      0,    300,    331,    331,    331,    331,    331,    331,    331,    331,    331,    331,    320,      0,      0,      0,      0    ],
        [   0,      0,      0,    300,    331,    331,    331,    331,    331,    331,    331,    331,    331,    331,    331,    331,    320,      2,      0,      0    ],
        [   0,      0,    300,    331,    331,    331,    331,    331,    331,    331,    331,    331,    331,    331,    331,    331,    331,    320,      0,      0    ],
        [  -1,    300,    331,    331,    331,    331,    331,    331,    331,    331,    331,    331,    331,    331,    331,    331,    331,    331,    320,      1    ],
        [ 330,    331,    331,    331,    331,    331,    331,    331,    331,    331,    331,    331,    331,    331,    331,    331,    331,    331,    331,    330    ]
    ]
}