{
    "name": "Level 2",
    "id": "level2",
    "from": "level1",
    "to": "level3",
    "data": [   
        [   0,      0,      0,      0,      0,      0,      0,      0,      0,      0,      0,      0,      0,      0,      0,      0,      0,      0,      1,      0    ],
        [   0,      0,      0,    332,    342,    342,    342,    342,    342,    342,    342,    342,    342,    342,    352,      0,      0,    332,    342,    352    ],
        [   0,      0,     362,     0,      0,      0,      0,      0,      0,      0,      0,      0,      0,      0,      0,    362,      0,      0,      0,      0    ],
        [   0,      0,      0,      0,      0,      0,      0,      0,      0,      0,      0,      0,      0,      0,      0,     -2,    362,      0,      0,      0    ],
        [ 362,      0,      0,      0,      0,    362,      0,      0,      0,      0,      0,      0,      0,      0,      0,      0,      0,    362,      0,      0    ],
        [   0,    362,      0,      0,    362,      0,      0,      0,    370,      0,      0,      0,      0,      0,      0,      0,      0,      0,      0,      0    ],
        [   0,      0,    362,      0,     -2,      0,      0,    300,    321,      0,      0,    362,      0,      0,    362,      0,      0,      0,      0,    362    ],
        [   0,      0,      0,      0,      0,      0,    300,    311,    321,      0,      0,      0,      0,      0,      0,      0,      0,      0,      0,      0    ],
        [   0,      0,      0,      0,    332,    342,    312,    312,    322,      0,      0,      0,      0,      0,      0,      0,      0,    362,      0,      0    ],
        [   0,      0,      0,      0,      0,      0,     -2,     -2,     -2,      0,      2,      2,      2,      2,      2,      0,      0,      0,      0,      0    ],
        [   0,      0,    362,      0,      0,      0,      0,      0,      0,      0,    332,    342,    342,    342,    320,      2,      0,      0,      0,      0    ],
        [   0,      0,      0,      0,      0,      0,      0,      0,      0,      0,      0,      0,      0,      0,    302,    320,      2,      2,      2,      0    ],
        [   0,      0,      0,      0,    332,    352,      0,      0,      0,      0,      0,      0,      0,      0,     -2,    302,    342,    342,    352,      0    ],
        [   0,      0,      0,      0,      0,      0,      0,    300,    310,      320,    0,      0,      0,      0,      0,      0,      0,      0,      0,      0    ],
        [   0,      0,      0,      0,      0,      0,      0,    301,    311,      321,    0,      0,    362,      0,      0,      0,      0,      0,      0,      0    ],
        [   0,      0,      0,      0,      0,      0,      0,    302,    312,      322,    0,      0,     -2,    362,      0,      0,      0,      0,      0,      0    ],
        [   0,      0,      0,      0,      0,      0,      0,      0,      0,      0,      0,      0,      0,     -2,    362,      0,      0,      0,      0,      0    ],
        [   0,      0,      0,      0,      0,      0,      0,      0,      0,      0,      0,      0,      0,      0,     -2,    332,    342,    352,      0,      0    ],
        [   0,    370,      0,     -1,      0,    370,      0,      0,      0,      0,      0,      0,      0,      0,      0,      0,      0,      0,      0,      0    ],
        [   0,    301,    340,    350,    360,    321,      0,    300,    360,    320,      0,      0,    300,    330,    340,    350,    360,    330,    320,      0    ]
    ]
}