{
    "name": "Level 5",
    "id": "level5",
    "from": "level5",
    "to": "win",
    "data": [   
        [  -2,     -2,     -2,     -2,     -2,    -2,      -2,     -2,     -2,     -2,     -2,     -2,     -2,     -2,     -2,     -2,     -2,     -2,     -2,     -2    ],
        [   0,      0,      0,      0,      0,      0,      0,      0,      0,      0,      0,      0,      0,      0,      0,      0,      0,      0,      0,      0    ],
        [   0,      0,      0,      0,      0,      0,      0,      2,      2,      0,      0,      0,      0,      0,      0,      0,      0,      0,      0,      0    ],
        [   0,    362,      0,      0,      0,      2,      0,    300,    320,      0,      0,      0,      0,      0,      0,      0,      0,      0,      0,      0    ],
        [   0,      0,    362,      0,      0,    362,      0,    301,    321,      0,      0,      0,      0,      0,      0,      0,      0,      0,      0,      0    ],
        [ 362,      0,      0,      0,      0,      0,      0,    301,    321,      0,      0,      0,      0,      0,    362,      0,      0,      0,      0,      0    ],
        [   0,      0,      0,      0,      0,      0,      1,    301,    321,     -1,      0,      0,      0,      0,     -2,      0,      0,      0,    362,      0    ],
        [   0,    362,      0,      0,    362,      0,    332,    351,    361,    342,    352,      0,      0,    362,      0,      0,      0,    362,     -2,      0    ],
        [   0,      0,      0,      2,      0,      0,      0,    301,    321,      0,      0,      2,      2,      2,      2,      2,      2,      0,      0,      0    ],
        [ 362,      0,      0,    362,      0,      0,      0,    302,    322,      0,      0,    332,    342,    342,    342,    342,    352,      0,      0,      0    ],
        [   0,      0,    362,      0,      0,      0,      0,      0,     -2,      0,      0,      0,      0,      0,      0,      0,      0,      0,    362,      2    ],
        [   0,      0,      0,      0,      0,    362,      0,      0,      0,      0,      0,      0,      0,      0,      0,      0,      0,      0,      0,    362    ],
        [   0,    362,      0,      0,    362,      0,      0,      0,      2,      2,      0,      2,      0,      0,      0,      0,      0,      0,      0,      0    ],
        [   0,      0,      0,      0,      0,      0,      0,    332,    342,    352,      0,    370,      0,      0,      0,      0,      0,      0,      0,      0    ],
        [ 362,      0,      0,      0,      0,      0,    362,     -2,     -2,     -2,      0,    371,      0,      0,      0,      0,      0,      0,      0,      0    ],
        [   0,      0,      0,      2,      0,      0,      0,      0,      0,      0,      0,    372,      0,      0,      0,      0,      0,      0,      0,      0    ],
        [   0,      0,    332,    342,    342,    352,      0,      0,    332,    352,      0,      0,      0,      0,      0,      0,      0,      2,      0,      0    ],
        [   0,      0,      0,      0,      0,      0,      0,      0,      0,      0,      0,    370,      2,    370,      0,      0,    332,    352,      0,      0    ],
        [   0,      0,      0,      0,      0,      0,    362,      0,      0,      0,    332,    312,    342,    322,      0,      0,      0,      0,      0,      0    ],
        [   2,      2,      2,      2,      2,      2,      2,      2,      2,      2,      2,      2,      2,      2,      2,      2,      2,      2,      2,      2    ]
    ]
}